gif: bwy ieb det
ozk: nsi gig lzz
dum: uni pwn
jur: pqx knb
lqw: tou eiu yte wio
fjf: off kco sxd
cfl: sxd
eir: avr lid
eyw: mjg mbh
zgc: out
cyp: ubl
dac: wfv efw uni vpv
dsk: juz
acm: pyh kcr jjq esx
knb: out
ixz: hxf ekm bmt
xdf: rbh
det: fnk sbj xqp vnk you
vdr: qqw
xcj: ron odf jqt
ojq: pyx mdb
fvi: shs ame
qvb: kzz geo gjk mew vur lwt kpl njw kpr mao qem sch qnu
bvj: ybk tya
myk: ekm hxf
fjh: hyr xbz
ytp: bjb egq knm
csn: fvi ifh
zjx: yym urj wsi
tou: qor gzk tfp xdf uyp ipq uvn zes yuq glz rhk nxz anc fkz mtz wil kfc isr ozk vfi
oor: mdb izs
thp: lhk jyc jgz
vwd: xri bvm
hlb: cxm mbh
nmp: izs mdb
eiz: vnk fnk you
csh: dex
mfy: iwd
qsm: scx yne usw rot
gmu: pdc nch gbj
svv: zlg
hvb: zvg upe jvt dsk
wjv: nch
mew: mfl dtj
sbj: ecb fvr kki brx fjf xun cfl leu ryp
jgi: zcp zlg woi
rcw: cay bbu
vkx: tgc zas zdv tci
tci: gia wnd
vyz: aeh wpp
ujf: yte wio
mkg: igo ctn zwb
nol: yte wio
aep: fep
otu: ohx nsu eir clx vau
jii: rof qvb
zbv: hcg mdb izs rmc
gyg: lic hlb
cot: myi
ebq: ixz myk
brx: mjq eos vdf
cnb: zrq vbo
hxf: vua tot
avr: gjb ywk rop xnp bjr
nxv: itu xxo
wfw: edr qab ggb voj kmv
gxs: bcy puo lin gqd
yet: ecw
eyh: xpn xri
gth: xiq
mtz: qxg dzs ybs
odm: mkg qmc
ltr: out
usw: lrt xpt ogf
urj: kqc zfi odm
wpt: vau clx eir ohx
ifh: shs xar ame
gnu: zgc gkk gad
shs: lbd
tzc: izs rmc hcg pyx
gzk: eun
esh: zbv wtt
tub: egq kub
jrx: dcn jyb
shy: xqp sbj fnk
gcw: ybk izk
qnu: agd ieh
qxb: usw rot scx yne
kbt: yuy
pyh: nhq ntb tbu kcd hik cro osd kqt evk qgf bhv mxm ufw uih oet yae qky ear dwi vdr kaf qlr szs gqf ohu
scx: xpt lrt ogz ogf
rmc: ayj hkp wyr evf wnb nxv snf sci hrt nfr wxu byb vyz gxs tbn ani
ajf: jdq
eun: dqo eyw mxl lic hlb
hcg: gxs byb ani snf nfr hkp
qgf: hjy thu
xiq: tou zmb eiu wio
nch: rha grb uem
qvd: eir nsu
upe: juz jse
wip: myk kqx
cgk: hju shs xar ame
kwj: wtt kuf efz
ptc: you xqp fnk sbj
ctn: koy uqj
wxu: xxo cgl
xzm: iwd rof
ekm: tot vua
iez: vwd eyh
caw: eiu zmb tou wio
sxd: cun hvb
adq: viz edy nbl bto
tyg: dtu qes kvv pne viz xry rgi fru lly
iio: rot usw scx
gjb: out
kcr: osd ohu cro ufw mxm qlr ear qky yae
mjg: esx kcr jjq ifp pyh
otm: wex pmn
bmt: tot xav
tya: ope otm
phw: ifp
off: hvb pgs inu cun
xxo: okw zbx zbs
upf: kcr
khr: wjv gmu
fju: ded kwj esh emd die
vfi: eun pyr gyg
vrx: you sbj fnk vnk xqp
uop: vuc uut nmp
rhk: gmm wfw lac
kvv: vbo
leu: hek kco off
vpp: phw xdo gtr axy lvz
zcp: det bwy
cun: jvt zvg
zbx: wio yte eiu
ykm: zui
wfk: ifh
zvg: juz gnu jse
qky: xee csn wfk
sso: hcg
ope: wex cle
ale: ecw
esx: szs ohu yae ntb nhq qky tbu ufw vdr osd kcd hik
pmn: xmk iwd qvb
pne: ice fep
lzz: ahb sit
dqo: mbh
qob: xmk
yiq: app hki jmo
okw: eiu yte tou wio
jse: zgc knh fdc
gfx: ifp jjq esx
snf: hlz eyb
swp: zmb
hkp: rxx vwd eyh
kcd: dac dum
slj: bho
qsb: izk tya
lvz: esx jjq kcr
lic: mjg mbh cxm
axy: pyh
izs: gxs tbn ani byb vyz nfr wxu sci hrt nxv eyp wnb smk hkp ayj iez wyr evf
mao: cql tci zdv zas
wnd: pyx izs rmc mdb
qab: mzw
yib: lhk
trv: dcn jyb
die: zbv wtt efz
gtr: jjq kcr pyh
ear: ykm
ecw: qvb iwd xmk rof
mxm: iio qsm qxb
ywk: out
bjr: out
uut: pyx rmc
hrt: cgl itu
wfv: vnk sbj you
kuf: hcg pyx izs
tfp: tcx rbh vut
mzw: trh acm gxd
gad: out
oqj: wpt
udc: out
baw: zth tzc uut nmp
evf: hlz aku eyb
juz: knh zgc gad fdc
fnk: kki fvr ecb umj vub cfl leu ryp trv jrx xun
jdq: wgt
ecb: mjq bfh vdf oqj
zlg: ieb shy
kub: esx ifp pyh
dex: bml kbt fgd
ryp: dcn
xpt: sym xcl
kbd: kbt lul
sym: sbj
ogz: xcl sym
lly: efr iwi ntl mpn
bml: yuy xgb
rop: out
axh: jyc jgz
gqa: sbj fnk xqp vnk you
edy: mpn rbn ntl efr iwi
koy: out
vbo: xjz dcx yon omr
jyc: xco opb upf
pqx: out
sch: ron jqt
hyr: xmk
gbj: rha uem
lya: vau clx
ice: ewq pln
mtm: gnu juz
kqs: pyx hcg mdb
cgl: lqw
zth: izs mdb pyx hcg
bpm: pdc gbj
geo: tci zdv tgc cql
lin: sqz yyl vve
rbh: fjw
sdw: gfx gxd acm
ayj: eyb hlz
ogf: eiz sym
vnk: jrx hyw cfl kki fjf xun trv brx csh ryp vub vvl umj dgi ecb zjx fvr rbr
lbd: you fnk xqp vnk
rgi: qsb iyc hhc
fmu: rof
ewq: rcw rtv
agd: emd esh kwj ded die
phd: nnk
jan: zth uut tzc
vaj: qob fvk wgt
nxz: pyr
cao: wfw lac
vvl: urj wsi puv
efw: you sbj vnk
dwi: qsm iio
gig: axh ahb
pyx: ani gxs tbn wxu nfr byb nxv snf hrt sci hkp ayj evf iez wyr smk eyp wnb
amn: fmu
mdb: gxs byb wxu sci hrt wnb eyp smk iez wyr evf ayj
vua: out
weo: gqa qyx
lhk: upf jsf xco
grb: vnk
rho: zui bpm zgq gmu
ieb: sbj xqp vnk
ame: ncp
fgd: yuy mij xgb
jyb: ebq ljq
tcx: iud fjw
igo: ltr koy zle udc
nsu: avr
aku: nds vox
ieh: kwj die
puo: sqz
jgz: jsf vkn
ifp: bhv ohu kqt qlr szs evk gqf hik kcd dwi osd vdr mxm uih yae ntb oet ear tbu
fhn: fjh amn rnz oev uxu
fjw: rmr zop jox
lul: yuy mij
iwi: yet
viz: cyp
qyx: xqp vnk fnk sbj you
wcn: cot kyz hdv
clx: avr lid vcg
qfl: bob uhj
mfl: oor pds ojq
cpd: bho hsh
kfc: gyg gnj
bcy: vve sqz
woi: ieb shy bwy
cro: csn
xbz: qvb iwd xmk
bvm: wvh
pwn: fnk sbj xqp you
zfi: qmc aoe mkg
fst: udc koy zle ltr uqj
kyz: myi
hsh: qvb rof
pln: dwj rtv
qmc: igo zwb ctn fst
mic: knm bjb
kpl: mfl
xjz: fjh rnz amn oev uxu
kll: mdb izs pyx
vve: nns nol
bjb: esx ifp
ujz: gif
ohu: khr hum ykm
pit: kll cui
kqt: khr
iud: vpp zop jox
yon: rnz
jnv: vau
fru: vbo zfs zrq
hki: out
fro: fju agd ieh
nbl: cyp fep
omr: fjh amn rnz uxu
wex: xmk
oil: fnk xqp you
gnj: eyw hlb
gxd: jjq ifp pyh esx
hlz: nds rce
byb: puo bcy lin gqd
fdc: out
qlr: iio
vkn: pyh jjq esx
efr: ale slj yet
sci: eyh mqs
yyl: nol usk
zfs: xjz fhn omr yon
tgc: gia sso wnd
app: out
rtv: jii bbu
iyc: tya
hjy: qyx gqa hoj
sit: lhk
nhq: xee csn
qes: fep ice cyp
jqt: fft
rxx: xri xpn bvm
mbh: ifp pyh esx
jee: ajf kyz tnq
bho: qvb xmk rof iwd
zmb: anc fkz mtz wil kfc isr ozk vfi uvn yuq cao glz rhk nxz gzk tfp xdf uyp ipq qor
wil: vut tcx rbh
ded: kuf
thu: gqa hoj
puv: zfi
fvr: esn dex
uem: you sbj
ybk: rfn ope
aoe: ctn zwb igo fst
oet: prw
aeh: jwd mpo
prw: zlg woi zcp
wju: iwi
wnb: eyb hlz
xnp: out
ohx: vcg
vox: wio eiu
nrz: iud fjw
lwt: fju ieh
tbn: pwb
vub: yym wsi
dgi: ehu
fvk: iwd rof xmk
tbu: dac qqw dum
sqz: usk
nns: tou
zdv: wnd
yuq: gmm lac
gxz: tot
hdv: myi
mpo: wio eiu yte
trh: kcr jjq pyh
xar: lbd xer
qqw: efw pwn uni vpv
szs: hum rho
xgb: ilk yiq
xdo: jjq pyh esx
vcg: rop xnp bjr
pds: izs mdb
ncp: sbj fnk
ixq: gxd acm gfx
gmm: ggb kmv
jmo: out
vuc: rmc hcg pyx
gqd: sqz
uyp: ybs xzn
nsi: yib sit thp ahb axh
you: vvl fvr kki jrx hyw csh leu ryp
kqx: bmt gxz ekm hxf
tlu: trh gfx gxd
yae: dum
pyr: eyw dqo hlb
jox: phw axy
zbs: zmb eiu yte wio
cay: qvb iwd xmk
njw: odf ron
yym: odm kqc
jvt: juz jse gnu
yte: ipq tfp xdf gzk qor ozk isr vfi kfc fkz mtz anc rhk nxz glz cao yuq uvn zes
smk: vwd mqs
ilk: pqx hki app jmo
rmr: gtr axy lvz
mmw: zmb eiu yte tou wio
nzb: knm egq
nds: tou zmb wio
gix: caw mmw xiq ujf
dzs: tub
izw: igo ctn zwb fst
fkz: lac
dtj: oor pds rya ojq
tnq: myi jdq vaj
mqs: xri bvm
bwy: vnk xqp fnk sbj
pwb: vzc mpo jwd
uih: thu weo gke hjy
cql: sso gia
kco: inu cun qme
aqr: rha oil ptc grb uem
rbn: ale slj yet
fft: zth tzc nmp
xcl: vnk xqp sbj fnk
nfr: rxx vwd
rce: tou yte zmb
ron: uop baw vul jan fft
hhc: izk
voj: sdw mzw ixq
lac: qab
vdf: lya jnv
ntb: jgi svv
pdc: oil ptc rha
kzz: tgc zas
vur: ron jqt
dtu: gcw bvj
opb: ifp jjq esx
lid: gjb ywk xnp
knh: out
ahb: jgz jyc lhk
ani: wpp aeh
ljq: ixz myk
hik: ujz
mxl: cxm
ufw: rho hum khr
aak: pit jgn
wxy: jee fru cnb wju lly qes pne aep wcn dtu bmi kvv edy viz xry bto rgi
kki: ehu jyb
zrq: dcx xjz fhn yon
rfn: cle pmn wex
vul: nmp vuc
qxg: nzb ytp
wsi: zfi odm kqc
pgs: upe
osd: iio
gjk: ieh agd awa fju
hju: ncp xer
gke: gqa
glz: ybs xzn qxg
zui: gbj
eos: jnv lya
bob: mke kll rnk
mke: hcg
rya: rmc
kaf: gke thu
dcn: ljq wip
kmv: nxn
xer: fnk sbj vnk you
kqc: wzi aoe izw
uqj: out
yne: ogf lrt xpt
uvn: gyg pyr gnj
umj: tts
qor: xzn qxg dzs
dcx: oev uxu amn
zas: wnd
gqf: weo gke hjy thu
vau: vcg
uhj: cui mke kqs rnk kll
rof: qem phd kpr mao kpl njw mew vur aak geo qfl gjk kzz xcj fro vkx
jsf: esx ifp
edr: sdw ixq mzw
emd: kuf
vzc: tou eiu
fep: pln ubl
eot: zop jox vpp
cxm: esx ifp pyh jjq kcr
wtt: pyx rmc
xqp: hyw jrx leu kki csh brx trv fjf vub ryp ecb dgi vvl fvr rbr zjx
wpp: vzc
bmi: iyc bvj qsb
lrt: eiz xcl vrx
xav: out
bfh: wpt lya qvd
odf: vul jan baw
eiu: ipq uyp tfp gzk qor isr ozk vfi wil fkz mtz anc rhk nxz glz cao yuq uvn zes
egq: esx ifp pyh kcr jjq
xun: vdf oqj
bhv: hjy
esn: kbt bml lul
mjq: otu
nxn: acm
xri: gth
wzi: fst
iwd: mew qem gjk kpr fro xcj
svr: adq mkr tyg wxy
knm: jjq kcr
tts: kbt fgd bml
ubl: rcw rtv dwj
jgn: kqs rnk cui mke
wyr: gqd bcy
isr: ybs xzn qxg
anc: lzz
hyw: hek
uyx: rnk kll kqs mke cui
wvh: ujf caw
mij: yiq jur ilk
qem: zdv
ipq: nrz
rbr: kbd tts
ehu: wip ljq
cui: hcg rmc mdb
mkr: edy pne kvv rgi jee cnb fru wju lly
uxu: xbz xzm
oev: mfy xzm xbz
eyb: vox
vpv: you sbj vnk xqp
wio: vfi isr kfc wil uyp xdf tfp anc nxz cao zes uvn
zwb: ltr
gkk: out
nnk: csw rya
xco: ifp
hek: inu qme hvb
efz: mdb rmc
zgq: pdc aqr
itu: zbs swp zbx okw
inu: dsk mtm
xpn: gth gix
rnz: xzm
mpn: yet cpd
eyp: cgl xxo
wgt: xmk rof iwd qvb
zle: out
kpr: pit uyx uhj
evk: jgi svv
zop: phw axy lvz
myi: qob wgt
bbu: qvb
xmk: xcj fro vkx kzz qfl gjk aak geo vur mew lwt njw kpl mao kpr qnu sch phd qem
zes: nsi
ybs: ytp nzb mic
bto: rbn
hoj: vnk sbj
tot: out
qme: mtm dsk jvt upe zvg
yuy: jur
awa: die esh
vut: eot iud
cle: qvb xmk rof
xry: tnq ajf cot kyz
rot: xpt ogf ogz
izk: rfn otm
csw: hcg izs rmc mdb
uni: xqp you
rha: you fnk
ggb: ixq nxn tlu
xzn: mic nzb
gia: pyx hcg rmc mdb
xee: cgk
hum: bpm zgq zui wjv
jwd: wio eiu yte zmb
rnk: pyx hcg rmc izs
ntl: ale cpd
jjq: ohu qgf evk kaf kqt qlr dwi hik yae ntb ufw
dwj: cay jii bbu
usk: zmb yte eiu
